333333333333333333333333333333
333333333333333333333333333333
333333333333333333333333333333
333333333333333333333333333333
333333333333333333333333333333
333333333333333333333333333333
333333333333333333333333333333
333333333333333333333333333333
333333333333333333333333333333
333333333333333333333333333333
333333333333333333333333333333
333333333333333333333333333333
333333333333333333333333333333
333333333333333333333333333333
333333333333333333333333333333
333333333333333333331111111111
222222222222222222221111111111
222222222222222222211111111111
222222222222222222111111111111
222222222222222221111111111111
222222222222222211111111111111
222222222222222111111111111111
222222222222221111111111111111
222222222222211111111111111111
222222222222111111111111111111
222222222221111111111111111111
222222222211111111111111111111
222222221111111111111111111111
222222111111111111111111111111
222211111111111111111111111111